##############################################
#                                            #
#                                            #
#                    O                       #
#                                            #
#                                            #
#                    X                       #
#                                            #
#                                            #
#                                            #
#                                            #
#                                            #
#                    P                       #
#                                            #
#                                            #
#                                            #
#                                            #
#                                            #
#                                            #
#                                            #
#                                            #
#                                            #
#                                            #
#                                            #
#                                            #
##############################################
